.............
.#.#.#.#.#.#.
.#.#.#.#.#.#.
.#.#.#N#.#.#.
.#.#.#.#.#.#.
.............
N.##.....##.N
.....###.....
.#.#.#.#.#.#.
.#.#.#.#.#.#.
.#.#.....#.#.
.#.#.###.#.#.
..P..#B#.....