...N...N.....
.#.N...#.#.#.
.#....##.#N#.
...#.....N...
G..#..N..#G#N
GG...#..N.G..
.###GGGN..G#.
...NG#.#.#.#.
N#.N.#.#...#.
.#.#.###.#N#.
.#.#.###.....
.#...###.#.#.
.#.#P#B#.###.