.#...........
.#.###.#...##
.#.#.#.#...##
.#.#.#.#...##
.#.#.#.#...##
.#.#.#.###.##
.#.#.#.#.#.##
.#.#.#...#.##
.#.#.#.#.#.##
.#.#.#.#.#...
.#.#.#.#####.
.###.#.#..##.
.......####..