.............
.............
.............
.............
.............
.............
.WWWWWWWWWWW.
.W...NNN...W.
.W#..#B#..#W.
.W#..###..#W.
.W#..#.#..#W.
.W.........W.
......P......